franco berrino|luigi fontana|la|grande via|alimentazione, movimento, meditazione|per una lunga vita felice sana e greativa|
bruno festa|polvere nera|1600 giorni di mussolini a gargnano
guide outdoor|90|sentieri|storici|in italia|scaprire antichi percersi|istituto geografico dsagostini|
arun gandhi|il dono della rabbia|e altre lezioni di mo nonna|mahatma gandhi|ggiunti|
opal denervatarie permanente slle ameggee|affari di armi|percors|di pace|artuelit ricercamemeria|per la pratica della nenvielenzs|emi|
serie manuali|diritto degli|enti locali|a o , n-13 344|xviii eio|el|smone|2008|
gli adelphi n|robert m. pirsig|lo zen|e l'arte della manutenzione|della motocicletta|
claudio|magris|microcosmi|premio strega 1997|saan|bant|
serie manuali|90|manuale di|biblioteconomia|e bibliografia|appaeal|po lep|dei docent d|d pr|cera di|nunale sivestre|simone|
umberto eco|numero|zero|
* gli adelphi|douglas r. hofstadter|gödel, escher, bach:|un 'eterna ghirlanda brillante|bach|sceer|
einaudi|stile libero extra|andre agassi|оpen|la mia storia|
tn'avventura entustasman|una Londra cpcsa e|fancinsa, sopeA|fantasia e resla|da n mastra|della nava|etteratura inglese|NEIL GAIMAN|NESSUN DOVE|PAC TRS|
ROBERTO|SAVIANO|Gomorra|Viaggio nell impero econemice|e nel sogno di dominio della camorna|
ALESSANDRO BARICCO|NEXT|Piccolo libro|sulla globalizzazione|esul mondo|che verra|BUPERUE|
aehe ha imena nariadWI Blalr T|LA|CANZONE|Dİ ORFEO|DAVID|ALMOND|Autore di Slcellig|SALAN|
JACK KEROUAC ON THE ROAD|PERENCE|
Murakami Haruki|Dance Dance Dance|ET.|Einaudi|
MASSIMO|GRAMELLINI|Fai bei sogni|ONANESI|
HERMANN VINKE|LA BREVE VITA|DI SOPHIE SCHOLL|l guste di leggere|
100PAGINE|1O00 liRE|HESSE|Knulp|Storia di un vagabando|
Emily Bennse|Cime tempestose|ENAUDN TABCADL|
Flaubert|Madame Bovary|Garzanti|
16 RACCONTI ITALIANI|LIBRERIA RINASCITA EDITRICE BRESCIA|
andrea camilleri|la scomparsa di Pate|LE|
Andre Comillen|LA MOSSA DEL CAVALLO|
Leggere narrativa|Giovanni Verga|I Malavoglia|Principate|
MARIATERESA|DI LASCIA|PASSAGGIO|IN OMBRA|
IAN|MCEWAN|Bambini|nel tempo|
ELIAS|CANETTI|La lingua|salvata|
GIORGIO|BASSANI|Il giardino|dei Finzi-Contini|
PETER|HANDKE|La donna|mancina|
GÜNTER|GRASS|Il tamburo|di latta|
F. Kafka|IL PROCESSO|L'ondinana amministratione|dell assedo|
Lienle n itri|ISABEL ALLENDE|IL PIANO INFINITO|
Uiersale letua|EDGAR ALLAN POE|LE AVVENTURE|DI GORDON PYM|Profaoe d Ato Benokco|Editon Runt|
Live|3900|EAPOE|Tutti i racconti|del mistero, dell'incubo|e del terrore|1TASCAM CONOMIC|NEWTON|
niente è come sembra|un film di franco battiato|
LIRE 2000 LIRE|DOSTOEVSKIJ|Delitto|e castigo|LOANOCA NEWN|
HUGO PRATT|CORTO MALTESE|UNA BALLAIA DEL MARE SALATO|
DACIA MARAINI|L'amore rubato|
FRANCESCO GUCCINI|ICARO|-25|UKAR|BES|
FRANCESCO|GUCCINI|Un matrimonio,|u* funerale,|per non parlar del gatte|
LORIANO|MACCHIAVELLI|EST|I SOTTERRANEI|DI BOLOGNA|
FRANCESCO GUCCINI|LORIANO MACCHIAVELLI|BEST|LO SPIRITO|E ALTRI BRIGANTI|
NICK HORNBY|Tutto|Per una|ragazza|
Nick Hornby|TUTTA UN'ALTRA MUSICA|
margaret mazzantini|venuto al mondo|BEST|
Rilke|le storie del buon Dio|TEC|
Pirandello|Non è una cosa seria|e abe novelle coniugal|000L|
Conmac McCanby|Oltre il confine|
ANDREA|DE CARLO|5900|DUE DI DUE|degl|Fann|Pietro Citali|Helo Calvino|
H.R LOVECRAFT|LE MONTAGNE DELLA FOLLIA|
AMOS OZ|UNA PANTERA|IN CANTINA|
WILACE TEE P E PR|MICHAEL CUNNINGHAM|THE|HOURS|
MARIO RIGONI STERN|SENTIERI SOTTO LA NEVE|
Enrico Brizzi|JACK FRUSCIANTE|E|ÜSCİTO|DAL GRUPPO|
Enrico Brizzi|La vita quotidiana|a Bologna ai tempi|di Vasco|
Alicia Gimener Bartlet|Riti di morte|Sellerio editore Palermo|
Thoreau|Welden|Vita net boschi|Non lesi , la pe|eve|Amo|che vi a|o0os|
Lier onica Htrin|DANIEL PENNAC|SIGNOR|MALAUSSENE|
INer|STEFANO BENNI|LA COMPAGNIA|DEI CELESTINI|
Daniel|Pennac|Grazie|
ET|Eaud|Philip Roth|PASTORALE AMERICANA|
Ray Bradbury|Fahrenheit 451|
RAY|BRADBURY|a|Paese|d'ottobre|
Ray|Bradbury|Omicidi|di annata|I'Unità|
Luigi Pirandello|Il fu Mattia Pascal|
CARLO LUCARELLI|L'ISOLA DELL'ANGELO CADUTO|MITI|LIRE|7900|
Carlo|Lucarelli|Lestate torbida|Nuniti/belle|6.500|
Banana Yoshimoto|L'abito di piume|
BANANA|YOSHIMOTO|Arcobaleno|ICanguri/Nril|
Lnersle Eomio rin|BANANA|YOSHIMOTO|AMRITA|
Lire|3900|DARWIN-|L'origine|delle specie|Lipe|da v|INVI|1872|
ENSTEN|Line|3900|Come io vedo|il mondo|La teoria|della relatività|La visione dell'universo del più|grande scienziato del nostro secolo|
SUERSAG.|UNIVERSALE R|Stephen Hawking|DAL BIG BANG|AI BUCHI NERI|Breve storia de tempe|
Stephen Ja y Gould|GLI ALBERI NON CRESCONO|FINO IN CIELO|Varieta ed eccellenza nella storia della vita|SCAR SASE MONAD|
100paciNE|1O00 liRE|EINSTEIN|Teoria dei quanti|di luce|
RICHARD|DAWKINS|IL GENE|EGOISTA|LA PARTE IMMORTALE|OGNI ESSEREVIVENTE|O OSCAR|MONDADORI|SAGGI|
Steven Weinberg|Alla ricerca|delle leggi ultime della fisica|
Jacques Monod|Il caso|e la necessità|
gli Adelphi|KONRAD LORENZ|L'anello|di Re Salomone|
Steven We inberg|I PRIMI|TRE MINUTI|L'affascinante storia|dell'origine dell'universo|0SCAR SAGG ONDAORt|
Biblioteca Scientifica 1|Gregory Bateson|VERSO UNECOLOGIA|DELLA MENTE|
Franco Berrino|IL CIBO|DELL'UOMO|La via della salute|tra conoscenza scientifica|e antiche saggezze|
gli Adelphi|EDWIN A. ABBOTT|Flatlandia|Raconte fantstie e pi din|
A. Gabrielli|LA VITA|GARIBALDI|
GIANNI RODARI|IL LIBRO DEGLI ERRORI|DISEGNI DI BRUND MUNARI|00|
GIANNI RODARI|C'ERA DUE VOLTE|IL BARONE LAMBERTO|
CARCO MUTO|Giuseppe Tandiola|ATLANTE FANTASTICO|DEL|MEDIOEVO|
GU STAUZZI s4|Gianni Rodari|Favole al telefono|SINAUDI|
Teresa Radice|Stefano Turconi|IL PORTO|PROIBITO|
Manuale|del Giovane|Giallista|di Stelania|Fabri|2.|MONBADORI|
500|PROGETTI|52|Kevin|Meredith|Laboratorie creativo per image-maker d'assalte|

MARK TWAIN|LE AVVENTURE|DI TOM SAWYER|lapie|Ensu a|
VAMBA|Il giornalino|di Gian|Burrasca|
A.F. HARROLD|Il mio amico immaginanario
JAMES FENIMORE|COOPER|L'ULTIMO|DEI|MOHICANI|Em Raga|
Rudyard kipling|IL libro|della giungla|alo GAANDO|I CLASSICI DEL BATTELLO A VAPORE|
Jonathan Swift|I viaggi|di Gulliver|dusione d EwanuA Naa|CLASSICI DEL BATTELLO A VAPORE|
Verne| viaggio al centro della terra CONCHIGLIE|
BOMPIANI|EMILIO SALGARI|Le Tigri|di Mompracem|strasioni di|Vlypo Brancl|GGIUNTI|
Reald Dahl|IL GGG|
MANUALE|DELTRAPPER|si ANDREA MERCANTI|
THE SUCCESS OF OPEN SOURCE|Steven Weber|
INCLUSIVE|DESIGN PATTERNS|Coding Accessibility Into Web Design|ja|by eyden Pikering|
Marshall|MeLuhan|GLI STRUMENTI|DEL COMUNICARE|
Theodor Holm Nelson|LITERARY|MACHINES|90.1|l progetto|Xanadu|
